mogul : An important or powerful person, especially in the motion picture or media industry.

distrust : the feeling of not trusting someone or something

paradigm : a model of something, or a very clear and typical example of something 範例，示例

accommodating : adj.   used to describe a person who is eager or willing to help other people, for example by changing his or her plans

get sth across  : (phrasal verb)  to manage to make someone understand or believe something    
                   Ex : We tried to "get our point across", but he just wouldn't listen.
get your strengths across  : make your abilities clear to somebody

compass : 指南針, 圓規, 界線
moral compass : a natural feeling that makes people know what is right and wrong and how they should behave 

be indifferent to : (NOT INTERESTED)
indifferent (adj) : (not good, but not very bad)

yawn : 打呵欠

proclaim   v. :  [formal] to announce something publicly or officially, especially something positive

assortment : a group of different types of something    Ex :  an assortment of vegetables

an integral part of  : necessary and important as a part of a whole

flourishing : adj. growing or developing successfully

tout : Attempt to sell (something), typically by pestering people in an aggressive or bold manner.

empathize (+with): v.  to be able to understand how someone else feels.  Ex :  It's very easy to empathize with the characters in her books.
empathetic (+towards): adj. Ex : she’s compassionate and empathetic towards her daughter.

sympathize : v. to understand and care about someone's problems
sympathetic (+about) : adj. used to describe someone who shows, especially by what they say, that they understand and care about someone else's suffering

compassion : a strong feeling of sympathy and sadness for the suffering or bad luck of others and a wish to help them
compassionate : adj  

pathetic : adj. causing feelings of sadness, sympathy, or sometimes lack of respect, especially because a person or an animal is suffering

apprehension : worry about the future, or a fear that something unpleasant is going to happen

misgiving : a feeling of doubt or worry about a future event

airtight  : adj. completely closed so that NO air can get in or out   Ex : an airtight container 保鮮盒

detergent : n. a chemical substance in the form of a powder or a liquid for removing dirt from clothes, dishes, etc.

洗碗精 dish soap ( US also "dish detergent", UK "washing-up liquid") a thick liquid detergent , added to hot water when washing pans, knives and forks, etc.

洗衣粉(精) washing powder/liquid  ( US "laundry detergent") : a detergent in the form of a powder or liquid that is used for washing clothes and other things made of cloth


disinfect : v. 給…殺菌，爲…除菌，替…消毒 to clean something using chemicals that kill bacteria and other very small living things that cause disease

debilitate : v. [formal]  to make someone or something physically weak

onslaught : n. a very powerful attack

underbelly (= weakest parts) ：Ex ： the soft underbelly of  
Ex：Small businesses are "the soft underbelly of" the British economy, and they need as much government support as possible.

flawed : adj. not perfect, or containing mistakes

misjudge ： v.  to form an opinion or idea about someone or something which is unfair or wrong
misjudgment ( also misjudgement)

skate over/round/around sth ： to avoid dealing completely with something or to fail to pay enough attention to it 
對…一帶而過；對…輕描淡寫 
Ex : I didn't understand what the teacher said about prepositions, because she only skated over it.

fend sth off : to avoid dealing with something that is unpleasant or difficult
Ex ： Somehow she managed to fend off the awkward questions.

make a profit/loss : to earn or lose more money than you spend

exaggerated : adj. 

immunize (against)： v.（通常指透過注射）使免疫 Ex ： Children are routinely immunized against polio(小兒麻痺). 
be immune to 免疫的

break the ice : [informal] 打破冷場

etiquette : /ˈet.ɪ.ket/ Social etiquette

penetrating : adj. 1. 響亮的，刺耳的  
                   2. 有洞察力的；目光銳利的 Ex : a penetrating mind 敏銳的頭腦
                   








